hello,world!
2222222222
3333333333
4444444444
9999999999
888888888
1111111111